tytul	zmienna	grupa tematyczna
100 Rad	STORAD	kobiece: poradniki
Auto Motor i Sport	AUMISP	męskie: hobby
Auto Świat	AUTOSW	męskie: hobby
Auto-Moto. Magazyn Zmotoryzowanych	AUTOMO	męskie: hobby
Budujemy Dom	BUDDOM	dom & wnętrze
Burda	BURDA	kobiece: hobbystyczne
Cała Ty	CALATY	kobiece: poradniki
Chwila dla Ciebie	CHWILA	kobiece: rozrywka
Claudia	CLAUD	kobiece: poradniki
Czas na Wnętrze	CZASWNE	dom & wnętrze
Dobre Rady	DOBRAD	kobiece: poradniki
Dobry Tydzień	DOBRTY	kobiece: rozrywka
Dziennik Bałtycki	DZBAL	dziennik
Dziennik Gazeta Prawna	GPRAWN	dziennik
Dziennik Łódzki	DLWD	dziennik
Dziennik Polski	DZPOL	dziennik
Dziennik Zachodni	DZZACH	dziennik
Echo Dnia	ECHOD	dziennik
Elle	ELLE	kobiece: exclusive
Express Bydgoski	EXBYD	dziennik
Express Ilustrowany	EXIL	dziennik
Fakt Gazeta Codzienna	FAKT	dziennik
Forbes. Profit	PROFIT	społeczne
Gazeta Krakowska	GKRAK	dziennik
Gazeta Lubuska	GLUBU	dziennik
Gazeta Pomorska	GPOMOR	dziennik
Gazeta Telewizyjna (Gazeta Wyborcza)	TELWYB	dodatek
Gazeta Wrocławska	SLPLGW	dziennik
Gazeta Współczesna	GWSP	dziennik
Gazeta Wyborcza	GAZWYB	dziennik
Glamour	GLAMOU	kobiece: exclusive
Głos Wielkopolski	GLWIEL	dziennik
Głos-Dziennik Pomorza	GLDZPM	dziennik
Gość Niedzielny	GOSCN	społeczne
Kobieta i Życie	KOBIZY	kobiece: poradniki
Kropka TV	KROPTV	telewizja
Kurier Lubelski	KURLUB	dziennik
Kurier Poranny	KURPOR	dziennik
Magazyn Telewizyjny Kurier TV	MAGKUR	telewizja
Mam Ogród	MOGROD	kobiece: hobbystyczne
Men's Health	MENSHE	męskie: hobby
Moje Gotowanie	MOJEGO	kobiece: hobbystyczne
Moje Mieszkanie	MOJEM	dom & wnętrze
Motor	MOTOR	męskie: hobby
Mój Piękny Ogród	PORDZ	kobiece: hobbystyczne
Murator	MURATO	dom & wnętrze
Na Żywo	NAZYWO	kobiece: rozrywka
Naj	NAJD	kobiece: poradniki
naszemiasto.pl	NASZMI	dziennik
National Geographic Polska	NATGEO	podróżnicze
National Geographic Traveler	NGTRAV	podróżnicze
Newsweek Polska	NEWSWE	społeczne
Nostalgia	NOSTA2	kobiece: rozrywka
Nowa Trybuna Opolska	TRYBOP	dziennik
Nowiny	NOWINY	dziennik
Nowości - Dziennik Toruński	NOWTOR	dziennik
O Czym Lekarze Ci Nie Powiedzą	OCZLEK	zdrowie & uroda
Olivia	OLIWIA	kobiece: poradniki
Pani	PANI	kobiece: exclusive
Pani Domu	PANID2	kobiece: poradniki
Parkiet Gazeta Giełdy	GAZGIE	dziennik
Party Życie Gwiazd	PARTY	kobiece: people
Polityka	POLIT	społeczne
Polska Metropolia Warszawska	POWAWA	dziennik
Poradnik 50+	POR50P	kobiece: poradniki
Poradnik Domowy	PORDOM	kobiece: poradniki
Przegląd Sportowy	DSPORT	dziennik
Przepis na Zdrowie	PRZDRO	zdrowie & uroda
Przyjaciółka	PRZYJ2	kobiece: poradniki
Przyślij Przepis	PPRZEP	kobiece: hobbystyczne
Puls Biznesu	PULBIZ	dziennik
Relaks	RELAKS	kobiece: rozrywka
Retro	ZYGORR	kobiece: rozrywka
Rewia	REWIA	kobiece: rozrywka
Rzeczpospolita	RZECZP	dziennik
Show	SHOW	kobiece: people
Sieci	WSIECI	społeczne
Sukcesy i Porażki	SUKPOR	kobiece: historie
Super Express	SUPEX	dziennik
Super TV	SUPERD	telewizja
Świat & Ludzie	SWILU	kobiece: rozrywka
Świat Kobiety	SKOBIE	kobiece: poradniki
Świat Seriali	SWISER	kobiece: rozrywka
Świat Wiedzy	SWWIED	pozostałe
Takie jest Życie	TAJEZM	kobiece: historie
Tele Magazyn	TEMAGA	dodatek
Tele Max	TELMAD	telewizja
Tele Świat	TELES2	telewizja
Tele Tydzień	TELTYD	telewizja
TEMI Galicyjski Tygodnik Informacyjny	TEMI	społeczne
Tina	TINA2	kobiece: poradniki
To & Owo	TOIOWO	telewizja
TV14	TV14	telewizja
Twoje Imperium	IMPER	kobiece: rozrywka
Twój Styl	TWOJST	kobiece: exclusive
Tygodnik Angora	ANGORA	społeczne
Tygodnik Ostrołęcki	TYOSTR	społeczne
Viva	VIVA__	kobiece: people
Vogue Polska	VOGUE	kobiece: exclusive
Women's Health	WOMEHM	kobiece: exclusive
Wysokie Obcasy (Gazeta Wyborcza)	WYOBCA	dodatek
Wysokie Obcasy Extra	WYOBEM	kobiece: exclusive
Z Życia Wzięte	ZZYCWZ	kobiece: historie
Zwierciadło	ZWIERC	kobiece: exclusive
Życie na Gorąco	ZYGOR	kobiece: rozrywka
